#######################S#
#   #         # #       #
# # # ####### # # ### ###
#   #   #     # #   #   #
# ### # ##### # ### ### #
#   # #     # #       # #
### ####### # ######### #
# #         # #       # #
# ########### # ##### # #
#     #   #   # #   #   #
# # # # # # ### # ##### #
# # #   # #     # #   # #
# # ##### ####### # # # #
# # #       #       #   #
# # # ####### ###########
# # # #     #       #   #
# # ### ### ####### ### #
# #     #     #   #   # #
# ####### ##### # ### # #
#   #   # #     #   # # #
### # ### # ####### # # #
# #   #   #   #   # #   #
# ### # ##### # # # ### #
#     #         # #     #
#E#######################
